{
    "world" : {
        "map" : [
            "~~~~~~~~~~~~~~~~",
            "~~~...........~~",
            "~..............~",
            "~..............~",
            "~.............~~",
            "~..............~",
            "~..............~",
            "~~.............~",
            "~..............~",
            "~~~......~~....~",
            "~~~~....~~~~..~~",
            "~~~~~~~~~~~~~~~~"
        ],
        "size": {
            "x": 16,
            "y": 12
        }
    }
}